▒▒▒▒▒▒▒▒▒▒▒▒▒▒▒▒▒▒▒▒▒▒▒▒▒▒▒▒▒▒▒▒▒▒▒▒▒▒▒▒▒▒▒▒▒▒▒▒▒▒▒▒▒▒▒▒▒▒▒▒
▒                                          ▒        ▒▒▒▒▒▒▒▒
▒                                          ▒        ▒      ▒
▒                                          ▒▒▒ ▒▒▒▒▒▒      ▒
▒                                          ▒        ▒      ▒
▒                                          ▒        ▒      ▒
▒                                          ▒▒▒▒▒ ▒▒▒▒▒▒ ▒▒▒▒
▒                                          ▒               ▒
▒                                          ▒               ▒
▒                                          ▒               ▒
▒                                          ▒               ▒
▒                  ▒▒▒▒▒▒▒▒▒▒▒▒▒▒▒▒▒▒▒▒▒▒▒▒▒▒▒▒▒▒▒▒ ▒▒▒▒▒▒▒▒
▒                  ▒                                       ▒
▒                  ▒                                       ▒
▒                  ▒                                       ▒
▒                  ▒                                       ▒
▒                  ▒                                       ▒
▒                  ▒                                       ▒
▒   ▒▒▒▒▒    ▓▓▓▓▓ ▒                                       ▒
▒▒▒▒▒▒▒▒▒▒▒▒▒▒▒▒▒▒▒▒                       ▒▒▒▒▒▒▒▒▒▒▒▒▒▒▒▒▒
▒          ▒                                               ▒
▒                                                          ▒
▒          ▒                                               ▒
▒▒▒▒▒▒▒▒▒▒▒▒▒▒▒▒▒▒▒▒▒▒▒▒▒▒▒▒▒▒▒▒▒▒▒▒▒▒▒▒▒▒▒▒▒▒▒▒▒▒▒▒▒▒▒▒▒▒▒▒